#########################
#.......................#
#.......................#
#....121111121111211....#
#......11211111211......#
#........1121121........#
#..........121..........#
#...........1...........#
#.......................#
#.......................#
#.......................#
#.......................#
#.......................#
#.........,.............#
#.......................#
#.......................#
#.......................#
#.......-----...........#
#.......................#