#########################
#.......................#
#.......................#
#.......................#
#...11111111111111111...#
#.....111111111.........#
#......22222............#
#.......................#
#.......................#
#.......................#
#.......................#
#.......................#
#.......................#
#.........,.............#
#.......................#
#.......................#
#.......................#
#.......-----...........#
#.......................#